XXXXXXXXXXXXXXXXXXX
0000000000000000000
0k................0
0...========....=.0
0...............=.0
0......000000...=.0
0......00p00==s.=.0
0......00.00==....0
0.................0
0.................0
0......000....000.0
0.........====x.0.0
0.000..000....0*0.0
0.00.==.......000.0
0.................0
0000000000000000000
XXXXXXXXXXXXXXXXXXX