XXXXXXXXXXXXXXXXXXX
#0000000000000000##
#0..............00#
#0.0000.=......=.0#
#0.=..s..........0#
#0.=00000.0000.000#
#0.=00000*0..0.0###
#0.=0000000..0.0###
#0..0000.....0p0###
#0...==..000.000###
#0.0.....000.0#####
#0...000.....0#####
#00000#0000000#####
###################
###################
###################
XXXXXXXXXXXXXXXXXXX