XXXXXXXXXXXXXXXXXXX
###################
###################
#000000000000000###
#0.............0###
#0.00000000000.0000
#0.000*.......=...0
#0.00000000000.00.0
#0.00000000000p00.0
#0.00000000000000.0
#0.00....00s.0000.0
#0................0
#0000000......00000
#######00000000####
###################
###################
XXXXXXXXXXXXXXXXXXX