XXXXXXXXXXXXXXXXXXX
###################
###################
###################
###################
###################
###################
###################
###################
###################
#000000000000000###
#0*...........p0###
#000000000000000###
###################
###################
###################
XXXXXXXXXXXXXXXXXXX