XXXXXXXXXXXXXXXXXXX
0000000000000000000
0..=...00....0....0
0.0...........=...0
0...00....000..0000
000.000...000....p0
00..000.0.00..+...0
00.....=.=........0
000...0.0.0......00
000..=.=.=.......00
0....s0.0.000000000
0..=...=.=..0....=0
0...0..=.=..0x0*0=0
0.......0....=000=0
0..0....0@0..====T0
0000000000000000000
XXXXXXXXXXXXXXXXXXX