XXXXXXXXXXXXXXXXXXX
###################
###################
###################
###################
###################
###################
#############000###
######00000##0*0###
###0000...0000.000#
#000.........0...0#
#0p..........0...0#
#0000...0.s......0#
####00000000000000#
###################
###################
XXXXXXXXXXXXXXXXXXX