XXXXXXXXXXXXXXXXXXX
###################
###################
###################
###################
###################
###################
#############000###
#############0*0###
#############0.0###
#0000000#00000.0###
#0p....0#0.....0###
#00000.000.00000###
#####0.....0#######
#####0000000#######
###################
XXXXXXXXXXXXXXXXXXX
