XXXXXXXXXXXXXXXXXXX
000000###0000######
0....0###0..000####
0....000#0....0####
00....s000....00###
#0....=..0...=.00##
00.00..0.00...=.0##
0..00...=......000#
0...0..=........k0#
0...0.0+000.0....0#
00..0..=..0=...000#
00.000000.0...=.0##
#0.0000p..0..=.00##
#0.x.*0...0...00###
#0@0000...00..0####
#000##000000000####
XXXXXXXXXXXXXXXXXXX