XXXXXXXXXXXXXXXXXXX
0000000000000000000
0*0..........000000
0.....000....000000
0000..0@0....000000
0............000000
0.0..........000000
0.000........000000
0x0p......t.+000000
0.000.....=..000000
0.0==....0.0.000000
0.0==....0.0.000000
0=.=.0...0...000000
0.0.00.t.0....00000
0..=.0...0...==k000
0....00000..0000000
0000000000000000000
XXXXXXXXXXXXXXXXXXX