XXXXXXXXXXXXXXXXXXX
0000000000000000000
0........0==0==...0
0.00......====.0..0
0.........====.0x00
0.........====.0.*0
0.....===.=....0000
0.....=.===.......0
0.....=...........0
00===&......=.....0
0?====............0
0..0..........00..0
0.............00000
0.0.0p0.0.........0
0...000...........0
0000000000000000000
XXXXXXXXXXXXXXXXXXX