XXXXXXXXXXXXXXXXXXX
###################
###################
###################
###################
###################
###################
###################
##000########000###
##0*0########0p0###
##0.0####00000.0###
##0.000000..00.0###
##0............0###
##0..00..0000..0###
##00000000##0000###
###################
XXXXXXXXXXXXXXXXXXX