XXXXXXXXXXXXXXXXXXX
###################
#00000######00000##
#0...00000000...0##
#0.0.00....00...0##
#0.............00##
#00.0000..0000.0###
##0.0#0....0#0.0###
##0p0#0....0#0*0###
##000#000000#000###
###################
###################
###################
###################
###################
###################
XXXXXXXXXXXXXXXXXXX