XXXXXXXXXXXXXXXXXXX
#######0000#000####
##000000..000.0####
##0..0...=..==0####
##0.......00..0####
#00.000.......00###
#0.=0@00000===.0###
#00.0......=..00###
##0.0.00...===0####
000.0.0......=0####
0k0.0+0....===0####
0=0.0.00000=.00000#
0=0.=.0*.x.=00.p.0#
0=00=000000...=..0#
0====0####00000000#
000000#############
XXXXXXXXXXXXXXXXXXX