XXXXXXXXXXXXXXXXXXX
###################
###################
###################
00000###00000######
0...00000...0######
0.0.00p00.0.0######
0..=..=..=..0000###
000.00.00.0000*0###
#00.00.00.0000.00##
#0....=..=..00..0##
#0s..0.00.0.0...0##
#0.....00...0.000##
#0.0000000000...0##
#0..............0##
#0000000000000000##
XXXXXXXXXXXXXXXXXXX