XXXXXXXXXXXXXXXXXXX
######0000#000000##
######0..000..0p0##
######0.=...=.0.0##
#####000.000.00.0##
000000..=000...=0##
0..000.0.0.0.00.00#
0.=...=.=.=0=..=.0#
0.=....0.0s0.00.00#
0.==0==.=.=.=.0.000
0.==0..0.0.0.00...0
0.==00..=.=.=.000x0
0.==00..00#0..0*..0
0.==.00000000000000
0...k0#############
000000#############
XXXXXXXXXXXXXXXXXXX