XXXXXXXXXXXXXXXXXXX
0000000000000000000
00k..............s0
0@.............t..0
00000...=.........0
00000.0t=.......0.0
000p..0.=.......0.0
0000000...........0
000*..0...........0
00000x0.........0.0
00000==.........0.0
0...=...........+.0
0.00=.0...........0
0.00==..........0.0
0...=.00..00..0...0
0000000000000000000
XXXXXXXXXXXXXXXXXXX
