XXXXXXXXXXXXXXXXXXX
###################
###################
###################
###################
###################
###################
#############000###
#############0p0###
###00000000000.000#
#000.............0#
#0*......s.......0#
#0000............0#
####00000000000000#
###################
###################
XXXXXXXXXXXXXXXXXXX